//MAP CONVERTED BY dmm2tgm.py THIS HEADER COMMENT PREVENTS RECONVERSION, DO NOT REMOVE
"a" = (
/turf/template_noop,
/area/template_noop)
"b" = (
/obj/structure/fluff/railing/border{
	icon_state = "border";
	dir = 9
	},
/obj/effect/decal/cobbleedge{
	dir = 6
	},
/turf/open/floor/rogue/woodturned,
/area/shuttle/arrival)
"c" = (
/obj/item/roguebin/water,
/turf/open/floor/rogue/woodturned,
/area/shuttle/arrival)
"d" = (
/obj/effect/decal/cobbleedge{
	dir = 1
	},
/turf/open/floor/rogue/ruinedwood/turned,
/area/shuttle/arrival)
"e" = (
/obj/structure/fluff/railing/border{
	icon_state = "border";
	dir = 1
	},
/obj/effect/decal/cobbleedge,
/obj/structure/chair/wood/rogue/chair3{
	dir = 4
	},
/obj/effect/landmark/latejoin,
/turf/open/floor/rogue/woodturned,
/area/shuttle/arrival)
"f" = (
/obj/structure/fluff/railing/border{
	icon_state = "border";
	dir = 1
	},
/obj/effect/decal/cobbleedge,
/obj/structure/table/wood{
	dir = 1;
	icon_state = "tablewood1"
	},
/turf/open/floor/rogue/woodturned,
/area/shuttle/arrival)
"g" = (
/obj/structure/fluff/railing/border{
	icon_state = "border";
	dir = 9
	},
/obj/effect/decal/cobbleedge{
	dir = 6
	},
/turf/open/floor/rogue/ruinedwood/turned,
/area/shuttle/arrival)
"h" = (
/obj/structure/fluff/railing/border{
	icon_state = "border";
	dir = 1
	},
/obj/structure/chair/bench/church/smallbench,
/obj/effect/landmark/latejoin,
/obj/effect/decal/cobbleedge,
/turf/open/floor/rogue/woodturned,
/area/shuttle/arrival)
"i" = (
/obj/structure/fluff/railing/border{
	icon_state = "border";
	dir = 8
	},
/obj/structure/fluff/railing/border,
/obj/structure/fluff/railing/border{
	icon_state = "border";
	dir = 10
	},
/obj/machinery/light/rogue/lanternpost{
	dir = 1
	},
/obj/effect/decal/cobbleedge{
	dir = 1
	},
/obj/effect/decal/cobbleedge{
	dir = 4
	},
/obj/effect/decal/cobbleedge{
	dir = 5
	},
/turf/open/floor/rogue/woodturned,
/area/shuttle/arrival)
"j" = (
/turf/open/floor/rogue/ruinedwood/turned,
/area/shuttle/arrival)
"k" = (
/obj/structure/fluff/railing/border,
/obj/structure/chair/bench/church/smallbench{
	dir = 1
	},
/obj/effect/landmark/latejoin,
/obj/effect/decal/cobbleedge{
	dir = 1
	},
/turf/open/floor/rogue/woodturned,
/area/shuttle/arrival)
"l" = (
/obj/structure/fluff/railing/border{
	icon_state = "border";
	dir = 5
	},
/obj/effect/decal/cobbleedge{
	dir = 10
	},
/turf/open/floor/rogue/woodturned,
/area/shuttle/arrival)
"m" = (
/obj/structure/closet/crate/roguecloset/inn/chest,
/obj/item/reagent_containers/glass/cup/wooden,
/obj/item/reagent_containers/glass/cup/wooden,
/obj/item/reagent_containers/glass/cup/wooden,
/obj/structure/fluff/railing/border{
	dir = 6;
	icon_state = "border"
	},
/obj/item/storage/box/matches,
/obj/effect/decal/cobbleedge{
	dir = 9
	},
/turf/open/floor/rogue/woodturned,
/area/shuttle/arrival)
"n" = (
/obj/structure/chair/wood/rogue/chair3{
	dir = 1
	},
/obj/effect/landmark/latejoin,
/turf/open/floor/rogue/woodturned,
/area/shuttle/arrival)
"o" = (
/obj/structure/fluff/railing/border,
/obj/structure/chair/bench/church/smallbench{
	dir = 1
	},
/obj/effect/landmark/latejoin,
/obj/effect/landmark/latejoin,
/obj/effect/decal/cobbleedge{
	dir = 1
	},
/turf/open/floor/rogue/woodturned,
/area/shuttle/arrival)
"p" = (
/obj/structure/fluff/railing/border{
	icon_state = "border";
	dir = 1
	},
/obj/structure/fluff/railing/border{
	icon_state = "border";
	dir = 8
	},
/obj/structure/fluff/railing/border{
	icon_state = "border";
	dir = 9
	},
/obj/effect/decal/cobbleedge,
/obj/effect/decal/cobbleedge{
	dir = 4
	},
/obj/effect/decal/cobbleedge{
	dir = 6
	},
/turf/open/floor/rogue/woodturned,
/area/shuttle/arrival)
"q" = (
/obj/structure/fluff/railing/border{
	icon_state = "border";
	dir = 1
	},
/obj/effect/decal/cobbleedge,
/turf/open/floor/rogue/woodturned,
/area/shuttle/arrival)
"r" = (
/obj/machinery/light/rogue/torchholder{
	icon_state = "torchwall1";
	dir = 8
	},
/obj/structure/chair/bench/church/smallbench{
	dir = 8
	},
/obj/effect/landmark/latejoin,
/turf/open/floor/rogue/woodturned,
/area/shuttle/arrival)
"s" = (
/obj/structure/fluff/railing/border{
	dir = 4;
	icon_state = "border"
	},
/obj/structure/closet/crate/chest,
/obj/structure/fluff/railing/border,
/obj/structure/fluff/railing/border{
	dir = 6;
	icon_state = "border"
	},
/obj/item/rogueweapon/huntingknife/stoneknife,
/obj/item/reagent_containers/glass/cup,
/obj/effect/decal/cobbleedge{
	dir = 1
	},
/obj/effect/decal/cobbleedge{
	dir = 8
	},
/turf/open/floor/rogue/woodturned,
/area/shuttle/arrival)
"t" = (
/obj/machinery/light/rogue/torchholder{
	icon_state = "torchwall1";
	dir = 4
	},
/obj/structure/chair/bench/church/smallbench{
	dir = 4
	},
/obj/effect/landmark/latejoin,
/turf/open/floor/rogue/ruinedwood/turned,
/area/shuttle/arrival)
"u" = (
/obj/docking_port/mobile/arrivals,
/obj/structure/fluff/railing/border{
	dir = 4;
	icon_state = "border"
	},
/obj/effect/decal/cobbleedge{
	dir = 8
	},
/turf/open/floor/rogue/woodturned,
/area/shuttle/arrival)
"v" = (
/obj/structure/fluff/railing/border,
/obj/structure/fluff/railing/border{
	icon_state = "border";
	dir = 8
	},
/obj/structure/fluff/railing/border{
	icon_state = "border";
	dir = 10
	},
/obj/effect/decal/cobbleedge{
	dir = 4
	},
/obj/effect/decal/cobbleedge{
	dir = 1
	},
/obj/effect/decal/cobbleedge{
	dir = 4
	},
/obj/effect/decal/cobbleedge{
	dir = 5
	},
/turf/open/floor/rogue/woodturned,
/area/shuttle/arrival)
"w" = (
/obj/structure/fluff/railing/border,
/obj/effect/decal/cobbleedge{
	dir = 1
	},
/turf/open/floor/rogue/woodturned,
/area/shuttle/arrival)
"x" = (
/obj/structure/fluff/railing/border,
/obj/effect/decal/cobbleedge{
	dir = 1
	},
/obj/structure/chair/wood/rogue/chair3{
	dir = 4
	},
/obj/effect/landmark/latejoin,
/turf/open/floor/rogue/woodturned,
/area/shuttle/arrival)
"y" = (
/obj/structure/fluff/railing/border{
	icon_state = "border";
	dir = 10
	},
/obj/effect/decal/cobbleedge{
	dir = 5
	},
/turf/open/floor/rogue/ruinedwood/turned,
/area/shuttle/arrival)
"z" = (
/obj/structure/fluff/railing/border{
	dir = 6;
	icon_state = "border"
	},
/obj/effect/decal/cobbleedge{
	dir = 9
	},
/turf/open/floor/rogue/woodturned,
/area/shuttle/arrival)
"A" = (
/obj/structure/fluff/railing/border{
	icon_state = "border";
	dir = 10
	},
/obj/effect/decal/cobbleedge{
	dir = 5
	},
/turf/open/floor/rogue/woodturned,
/area/shuttle/arrival)
"B" = (
/obj/machinery/light/rogue/torchholder{
	icon_state = "torchwall1";
	dir = 4
	},
/turf/open/floor/rogue/woodturned,
/area/shuttle/arrival)
"C" = (
/obj/structure/fluff/wallclock,
/obj/machinery/light/rogue/firebowl/standing,
/turf/open/floor/rogue/woodturned,
/area/shuttle/arrival)
"D" = (
/obj/structure/fluff/railing/border,
/obj/effect/decal/cobbleedge{
	dir = 1
	},
/obj/structure/table/wood{
	dir = 1;
	icon_state = "tablewood1"
	},
/turf/open/floor/rogue/woodturned,
/area/shuttle/arrival)
"E" = (
/obj/structure/fluff/railing/border{
	dir = 4;
	icon_state = "border"
	},
/obj/structure/closet/crate/roguecloset/inn/chest,
/obj/item/reagent_containers/glass/cup/wooden,
/obj/structure/fluff/railing/border{
	icon_state = "border";
	dir = 1
	},
/obj/structure/fluff/railing/border{
	icon_state = "border";
	dir = 5
	},
/obj/item/reagent_containers/glass/cup,
/obj/item/reagent_containers/glass/cup,
/obj/item/clothing/under/roguetown/tights/vagrant,
/obj/item/clothing/suit/roguetown/shirt/undershirt/vagrant,
/obj/item/clothing/shoes/roguetown/simpleshoes,
/obj/effect/decal/cobbleedge,
/obj/effect/decal/cobbleedge{
	dir = 8
	},
/turf/open/floor/rogue/woodturned,
/area/shuttle/arrival)
"F" = (
/obj/structure/fluff/railing/border{
	icon_state = "border";
	dir = 1
	},
/obj/structure/fluff/railing/border{
	icon_state = "border";
	dir = 8
	},
/obj/structure/fluff/railing/border{
	dir = 9;
	icon_state = "border"
	},
/obj/machinery/light/rogue/lanternpost{
	dir = 1
	},
/obj/effect/decal/cobbleedge{
	dir = 4
	},
/obj/effect/decal/cobbleedge,
/obj/effect/decal/cobbleedge{
	dir = 6
	},
/turf/open/floor/rogue/woodturned,
/area/shuttle/arrival)
"G" = (
/turf/closed/wall/mineral/rogue/wood/window,
/area/shuttle/arrival)
"H" = (
/obj/structure/fluff/railing/border{
	icon_state = "border";
	dir = 1
	},
/obj/machinery/light/rogue/lanternpost,
/obj/effect/decal/cobbleedge,
/turf/open/floor/rogue/woodturned,
/area/shuttle/arrival)
"J" = (
/obj/machinery/light/rogue/torchholder{
	icon_state = "torchwall1";
	dir = 8
	},
/obj/structure/fluff/railing/border{
	icon_state = "border";
	dir = 9
	},
/obj/structure/fluff/railing/border{
	icon_state = "border";
	dir = 10
	},
/obj/effect/decal/cobbleedge{
	dir = 5
	},
/obj/effect/decal/cobbleedge{
	dir = 6
	},
/turf/open/floor/rogue/woodturned,
/area/shuttle/arrival)
"K" = (
/obj/structure/fluff/railing/border{
	icon_state = "border";
	dir = 1
	},
/obj/structure/chair/bench/church/smallbench,
/obj/structure/fluff/railing/border{
	icon_state = "border";
	dir = 8
	},
/obj/structure/fluff/railing/border{
	icon_state = "border";
	dir = 9
	},
/obj/effect/landmark/latejoin,
/obj/effect/decal/cobbleedge,
/obj/effect/decal/cobbleedge{
	dir = 4
	},
/obj/effect/decal/cobbleedge{
	dir = 6
	},
/turf/open/floor/rogue/woodturned,
/area/shuttle/arrival)
"L" = (
/obj/structure/fluff/railing/border{
	dir = 8;
	icon_state = "border"
	},
/obj/structure/fluff/railing/border{
	icon_state = "border";
	dir = 1
	},
/obj/structure/fluff/railing/border,
/obj/structure/fluff/railing/border{
	icon_state = "border";
	dir = 10
	},
/obj/structure/fluff/railing/border{
	icon_state = "border";
	dir = 9
	},
/obj/effect/decal/cobbleedge{
	dir = 4
	},
/obj/effect/decal/cobbleedge{
	dir = 8
	},
/turf/open/floor/rogue/woodturned,
/area/shuttle/arrival)
"M" = (
/obj/item/reagent_containers/glass/cup/wooden,
/obj/structure/table/wood{
	dir = 1;
	icon_state = "tablewood1"
	},
/turf/open/floor/rogue/woodturned,
/area/shuttle/arrival)
"N" = (
/turf/closed/wall/mineral/rogue/wood,
/area/shuttle/arrival)
"O" = (
/obj/structure/fluff/railing/border{
	icon_state = "border";
	dir = 1
	},
/obj/structure/chair/bench/church/smallbench,
/obj/structure/fluff/railing/border{
	icon_state = "border";
	dir = 4
	},
/obj/structure/fluff/railing/border{
	icon_state = "border";
	dir = 5
	},
/obj/effect/landmark/latejoin,
/obj/effect/decal/cobbleedge,
/obj/effect/decal/cobbleedge{
	dir = 8
	},
/turf/open/floor/rogue/woodturned,
/area/shuttle/arrival)
"P" = (
/obj/effect/decal/cobbleedge,
/turf/open/floor/rogue/ruinedwood/turned,
/area/shuttle/arrival)
"R" = (
/obj/structure/closet/crate/roguecloset/inn/chest,
/obj/item/flashlight/flare/torch,
/obj/structure/fluff/railing/border,
/obj/structure/fluff/railing/border{
	icon_state = "border";
	dir = 4
	},
/obj/structure/fluff/railing/border{
	dir = 6;
	icon_state = "border"
	},
/obj/item/clothing/under/roguetown/tights/vagrant,
/obj/item/clothing/under/roguetown/tights/vagrant,
/obj/item/clothing/suit/roguetown/shirt/undershirt/vagrant,
/obj/item/clothing/suit/roguetown/shirt/undershirt/vagrant,
/obj/effect/decal/cobbleedge{
	dir = 1
	},
/obj/effect/decal/cobbleedge{
	dir = 8
	},
/turf/open/floor/rogue/woodturned,
/area/shuttle/arrival)
"S" = (
/turf/open/floor/rogue/woodturned,
/area/shuttle/arrival)
"T" = (
/obj/structure/chair/wood/rogue/chair3,
/obj/effect/landmark/latejoin,
/turf/open/floor/rogue/woodturned,
/area/shuttle/arrival)
"U" = (
/obj/structure/fluff/railing/border,
/obj/structure/chair/bench/church/smallbench{
	dir = 1
	},
/obj/structure/fluff/railing/border{
	icon_state = "border";
	dir = 8
	},
/obj/structure/fluff/railing/border{
	icon_state = "border";
	dir = 10
	},
/obj/effect/landmark/latejoin,
/obj/effect/decal/cobbleedge{
	dir = 1
	},
/obj/effect/decal/cobbleedge{
	dir = 4
	},
/obj/effect/decal/cobbleedge{
	dir = 5
	},
/turf/open/floor/rogue/woodturned,
/area/shuttle/arrival)
"V" = (
/obj/machinery/light/rogue/firebowl/standing,
/turf/open/floor/rogue/woodturned,
/area/shuttle/arrival)
"W" = (
/obj/structure/fluff/railing/border,
/obj/machinery/light/rogue/lanternpost,
/obj/effect/decal/cobbleedge{
	dir = 1
	},
/turf/open/floor/rogue/woodturned,
/area/shuttle/arrival)
"X" = (
/obj/structure/fluff/railing/border,
/obj/structure/chair/bench/church/smallbench{
	dir = 1
	},
/obj/structure/fluff/railing/border{
	dir = 4;
	icon_state = "border"
	},
/obj/effect/landmark/latejoin,
/obj/effect/decal/cobbleedge{
	dir = 1
	},
/obj/effect/decal/cobbleedge{
	dir = 8
	},
/obj/effect/decal/cobbleedge{
	dir = 9
	},
/turf/open/floor/rogue/woodturned,
/area/shuttle/arrival)
"Y" = (
/obj/structure/fluff/railing/border{
	icon_state = "border";
	dir = 1
	},
/obj/structure/fluff/railing/border{
	icon_state = "border";
	dir = 4
	},
/obj/structure/fluff/railing/border{
	icon_state = "border";
	dir = 5
	},
/obj/effect/decal/cobbleedge,
/obj/effect/decal/cobbleedge{
	dir = 8
	},
/obj/effect/decal/cobbleedge{
	dir = 10
	},
/turf/open/floor/rogue/woodturned,
/area/shuttle/arrival)

(1,1,1) = {"
a
a
a
L
a
a
a
"}
(2,1,1) = {"
a
a
p
J
v
a
a
"}
(3,1,1) = {"
a
a
q
N
w
a
a
"}
(4,1,1) = {"
a
F
b
t
A
i
a
"}
(5,1,1) = {"
a
e
S
j
S
x
a
"}
(6,1,1) = {"
a
f
S
j
S
D
a
"}
(7,1,1) = {"
K
g
j
j
j
y
U
"}
(8,1,1) = {"
h
j
T
M
n
j
o
"}
(9,1,1) = {"
P
j
V
G
C
j
d
"}
(10,1,1) = {"
P
j
S
c
S
j
d
"}
(11,1,1) = {"
h
j
j
j
j
j
k
"}
(12,1,1) = {"
O
l
S
r
S
z
X
"}
(13,1,1) = {"
a
H
S
N
S
W
a
"}
(14,1,1) = {"
a
Y
l
B
m
R
a
"}
(15,1,1) = {"
a
a
E
u
s
a
a
"}
