//MAP CONVERTED BY dmm2tgm.py THIS HEADER COMMENT PREVENTS RECONVERSION, DO NOT REMOVE
"a" = (
/turf/template_noop,
/area/template_noop)
"b" = (
/obj/structure/fluff/railing/border{
	icon_state = "border";
	dir = 1
	},
/turf/open/floor/rogue/woodturned,
/area/shuttle/arrival)
"c" = (
/obj/structure/fluff/railing/border,
/turf/open/floor/rogue/woodturned,
/area/shuttle/arrival)
"d" = (
/obj/structure/fluff/railing/border{
	dir = 8;
	icon_state = "border"
	},
/turf/open/floor/rogue/woodturned,
/area/shuttle/arrival)
"e" = (
/obj/item/reagent_containers/glass/cup/wooden,
/obj/structure/table/wood{
	dir = 1;
	icon_state = "tablewood1"
	},
/turf/open/floor/rogue/woodturned,
/area/shuttle/arrival)
"f" = (
/turf/closed/wall/mineral/rogue/wood/window,
/area/shuttle/arrival)
"g" = (
/obj/structure/fluff/railing/border{
	icon_state = "border";
	dir = 10
	},
/turf/open/floor/rogue/woodturned,
/area/shuttle/arrival)
"h" = (
/turf/open/floor/rogue/ruinedwood/turned,
/area/shuttle/arrival)
"i" = (
/obj/machinery/light/rogue/torchholder{
	icon_state = "torchwall1";
	dir = 8
	},
/obj/structure/chair/bench/church/smallbench{
	dir = 8
	},
/obj/effect/landmark/latejoin,
/turf/open/floor/rogue/woodturned,
/area/shuttle/arrival)
"j" = (
/obj/structure/fluff/railing/border{
	icon_state = "border";
	dir = 1
	},
/obj/structure/fluff/railing/border{
	dir = 4;
	icon_state = "border"
	},
/obj/structure/fluff/railing/border{
	icon_state = "border";
	dir = 5
	},
/obj/machinery/light/rogue/lanternpost,
/turf/open/floor/rogue/woodturned,
/area/shuttle/arrival)
"k" = (
/obj/structure/chair/wood/rogue/chair3{
	dir = 1
	},
/obj/effect/landmark/latejoin,
/turf/open/floor/rogue/woodturned,
/area/shuttle/arrival)
"l" = (
/obj/structure/closet/crate/roguecloset/inn/chest,
/obj/item/flashlight/flare/torch,
/turf/open/floor/rogue/woodturned,
/area/shuttle/arrival)
"m" = (
/obj/structure/closet/crate/roguecloset/inn/chest,
/obj/item/reagent_containers/glass/cup/wooden,
/obj/item/reagent_containers/glass/cup/wooden,
/obj/item/reagent_containers/glass/cup/wooden,
/turf/open/floor/rogue/woodturned,
/area/shuttle/arrival)
"n" = (
/obj/structure/fluff/railing/border{
	dir = 4;
	icon_state = "border"
	},
/obj/structure/closet/crate/roguecloset/inn/chest,
/obj/item/flashlight/flare/torch,
/obj/item/flashlight/flare/torch,
/turf/open/floor/rogue/woodturned,
/area/shuttle/arrival)
"o" = (
/obj/machinery/light/rogue/torchholder{
	icon_state = "torchwall1";
	dir = 8
	},
/turf/open/floor/rogue/woodturned,
/area/shuttle/arrival)
"p" = (
/obj/structure/fluff/wallclock,
/turf/open/floor/rogue/woodturned,
/area/shuttle/arrival)
"q" = (
/obj/structure/fluff/railing/border{
	icon_state = "border";
	dir = 1
	},
/obj/structure/fluff/railing/border{
	dir = 8;
	icon_state = "border"
	},
/obj/structure/fluff/railing/border{
	dir = 9;
	icon_state = "border"
	},
/obj/machinery/light/rogue/lanternpost{
	dir = 1
	},
/turf/open/floor/rogue/woodturned,
/area/shuttle/arrival)
"r" = (
/obj/structure/chair/wood/rogue/chair3,
/obj/effect/landmark/latejoin,
/turf/open/floor/rogue/woodturned,
/area/shuttle/arrival)
"s" = (
/obj/structure/fluff/railing/border{
	dir = 4;
	icon_state = "border"
	},
/obj/structure/closet/crate/chest,
/turf/open/floor/rogue/woodturned,
/area/shuttle/arrival)
"t" = (
/obj/machinery/light/rogue/torchholder{
	icon_state = "torchwall1";
	dir = 4
	},
/obj/structure/chair/bench/church/smallbench{
	dir = 4
	},
/obj/effect/landmark/latejoin,
/turf/open/floor/rogue/ruinedwood/turned,
/area/shuttle/arrival)
"u" = (
/obj/docking_port/mobile/arrivals,
/obj/structure/fluff/railing/border{
	dir = 4;
	icon_state = "border"
	},
/turf/open/floor/rogue/woodturned,
/area/shuttle/arrival)
"v" = (
/obj/structure/fluff/railing/border{
	icon_state = "border";
	dir = 1
	},
/obj/structure/chair/wood/rogue/chair3{
	dir = 4
	},
/obj/effect/landmark/latejoin,
/turf/open/floor/rogue/woodturned,
/area/shuttle/arrival)
"w" = (
/turf/open/floor/rogue/woodturned,
/area/shuttle/arrival)
"x" = (
/obj/item/roguebin/water,
/turf/open/floor/rogue/woodturned,
/area/shuttle/arrival)
"y" = (
/obj/structure/fluff/railing/border{
	icon_state = "border";
	dir = 1
	},
/obj/structure/table/wood{
	dir = 1;
	icon_state = "tablewood1"
	},
/turf/open/floor/rogue/woodturned,
/area/shuttle/arrival)
"z" = (
/obj/structure/fluff/railing/border,
/obj/structure/closet/crate/chest,
/obj/item/clothing/suit/roguetown/shirt/rags,
/turf/open/floor/rogue/woodturned,
/area/shuttle/arrival)
"A" = (
/obj/structure/fluff/railing/border{
	dir = 4;
	icon_state = "border"
	},
/obj/structure/closet/crate/roguecloset/inn/chest,
/obj/item/rogueweapon/huntingknife/idagger,
/turf/open/floor/rogue/woodturned,
/area/shuttle/arrival)
"I" = (
/obj/structure/fluff/railing/border{
	dir = 9;
	icon_state = "border"
	},
/turf/open/floor/rogue/woodturned,
/area/shuttle/arrival)
"K" = (
/obj/structure/fluff/railing/border{
	dir = 8;
	icon_state = "border"
	},
/obj/structure/fluff/railing/border,
/obj/structure/fluff/railing/border{
	dir = 10;
	icon_state = "border"
	},
/obj/machinery/light/rogue/lanternpost{
	dir = 1
	},
/turf/open/floor/rogue/woodturned,
/area/shuttle/arrival)
"O" = (
/obj/structure/fluff/railing/border{
	icon_state = "border";
	dir = 1
	},
/obj/structure/chair/wood/rogue/chair3{
	dir = 8
	},
/obj/effect/landmark/latejoin,
/turf/open/floor/rogue/woodturned,
/area/shuttle/arrival)
"P" = (
/obj/structure/fluff/railing/border{
	dir = 4;
	icon_state = "border"
	},
/obj/structure/closet/crate/roguecloset/inn/chest,
/obj/item/reagent_containers/glass/cup/wooden,
/turf/open/floor/rogue/woodturned,
/area/shuttle/arrival)
"Q" = (
/obj/structure/fluff/railing/border,
/obj/structure/fluff/railing/border{
	dir = 4;
	icon_state = "border"
	},
/obj/structure/fluff/railing/border{
	dir = 6;
	icon_state = "border"
	},
/obj/machinery/light/rogue/lanternpost,
/turf/open/floor/rogue/woodturned,
/area/shuttle/arrival)
"R" = (
/obj/structure/fluff/railing/border{
	dir = 8;
	icon_state = "border"
	},
/obj/structure/fluff/railing/border,
/obj/machinery/light/rogue/lanternpost{
	dir = 1
	},
/obj/structure/fluff/railing/border{
	dir = 10;
	icon_state = "border"
	},
/turf/open/floor/rogue/woodturned,
/area/shuttle/arrival)
"S" = (
/turf/closed/wall/mineral/rogue/wood,
/area/shuttle/arrival)
"T" = (
/obj/machinery/light/rogue/torchholder{
	icon_state = "torchwall1";
	dir = 4
	},
/turf/open/floor/rogue/woodturned,
/area/shuttle/arrival)

(1,1,1) = {"
a
q
d
d
d
K
a
"}
(2,1,1) = {"
a
b
w
o
w
c
a
"}
(3,1,1) = {"
a
b
w
S
w
c
a
"}
(4,1,1) = {"
q
I
w
t
w
g
R
"}
(5,1,1) = {"
v
w
w
h
w
w
c
"}
(6,1,1) = {"
y
w
w
h
w
w
c
"}
(7,1,1) = {"
O
h
h
h
h
h
c
"}
(8,1,1) = {"
b
h
r
e
k
h
c
"}
(9,1,1) = {"
h
h
w
f
p
h
h
"}
(10,1,1) = {"
h
h
w
x
w
h
h
"}
(11,1,1) = {"
b
h
h
h
h
h
c
"}
(12,1,1) = {"
v
w
w
i
w
w
c
"}
(13,1,1) = {"
y
w
w
S
w
w
c
"}
(14,1,1) = {"
O
w
w
T
m
l
z
"}
(15,1,1) = {"
j
n
P
u
s
A
Q
"}
